11111111
1P0C00E1
11100001
1C100001
11111111