11111111
1P0C0001
1E100001
1C100001
11111111