11111111111111111111111111111111111111111111111111111111111
10000000000000000000000111100000000000000000000001111111111
10000000000000000000000111100000000000000000000001111111111
100000C000000000000000011110000000000000C000000001111111111
10000000000000000000000111100000000000000000000001111111111
10000000000000000000000000000000000000000000000001111111111
10000111111111111111111111111111100000000000000001111111111
10000111111111111111111111111111100000000000000001111111111
10000111111111111111111111111111100000000000000001111111111
10000111111111111111111111111111100000000000000001111111111
10000111111111111111111111111111100000000000000001111111111
10000111111111111111111111111111100000000000000001111111111
10000111111111111111111111111111100000000000000001111111111
10000111111111111111111111111111100000000000000001111111111
10000000000000000000000000000000000000000000000001111111111
100000000000000000P0000000000000000000000000000001111111111
100000000000000000000000000000C000000000000C000001111111111
10000000000000000000000000000000000000000000000001111111111
10000000000000000000000000000000000000000000000001111111111
10000000000000000000000111100000000000000000000001111111111
10000000000000000000000111100000000000000000000001111111111
10000000000000000000000111100000000000000000000001111111111
10000000000000000000000000000000000000000000000001111111111
10000111111111111111111111111111100000000000000001111111111
10000111111111111111111111111111100000000000000001111111111
10000111111111111111111111111111100000000000000001111111111
10000000000000000000000000000000000000000000000001111111111
10000000000000000000000111111111111111111111000001111111111
100000000000000000000000000000000000000000C0000000000000E01
11111111111111111111111111111111111111111111111111111111111