11111111111111111111111111111111111111111111111111
10000000000000000000000111100000000000000000000001
10000000000000000000000111100000000000000000000001
100000C000000000000000011110000000000000C000000001
10000000000000000000000111100000000000000000000001
10000000000000000000000000000000000000000000000001
10000111111111111111111111111111100000000000000001
10000000000000000000000000000000000000000000000001
100000000000000000P0000000000000000000000000000001
100000000000000000000000000000C000000000000C000001
10000000000000000000000000000000000000000000000001
10000000000000000000000000000000000000000000000001
10000000000000000000000111100000000000000000000001
10000000000000000000000111100000000000000000000001
10000000000000000000000111100000000000000000000001
10000000000000000000000000000000000000000000000001
10000000000000000000000000000000000000000000000001
10000000000000000000000000000000000000000000000001
10000000000000000000000000000000000000000000000001
10000000000000000000000000000000000000000000000001
10000000000000000000000111111111111111111111000001
100000000000000000000000000000000000000000C0000001
10000000000000000000000000000000000000000000000001
10000000000000000000000000000000000000000000000001
10000000000000000000000111100000000000000000000001
10000000000000000000000111100000000000000000000001
10000000000000000000000111100000000000000000000001
10000000000000000000000000000000000000000000000001
10000000000000000000000000000000000000000000000001
10000000000000000000000111100000000000000000000001
10000000000000000000000111100000000000000000000001
100000000000000000000000000000000000000000000E0001
11111111111111111111111111111111111111111111111111