11111111111
1P000C00001
1000C000001
111111000E1
11111111111